000000000000000
000011911111110
000111011111110
001111011111110
011811011111110
011111111111110
011111111111110
011111111111110
011111111111110
011111111111110
011111111111110
011111111111110
011111111111110
011111111111110
000000000000000