000000000000
011100000000
018111100000
011111111100
001111111110
000000119110
000000011100
000000000000