000000000000000000
000000000111100000
081100000111100000
011111111100111110
011100001110001910
011100001110001110
001110001000001110
000111111000000000
000000000000000000